111111111111111111
10000000C000000C01
1000000P00000000C1
11010000000C000001
11E100000000000C11
111111111111111111