111111111111111111
111111111111111111
10000000C000000C01
1000000P00000000C1
10E10000000C000001
111111111111111011
111111111111111111