1111111111111111111111111111111111111111
1C000000000000000000C00000000000000000C1
1011C00001111101C0000000C1011111011C0001
1011C000011C00011C00000C11011C00011C0001
1011C000011C000011C000C110011C00011C0001
1011C00001111100011C0C1100011111011E0001
10111111011C00000011C11000011C0001111101
1011111101111100000010000001111101111101
10C0C0C0C0C0C0C0C00C0C0C0C0C0C0C0C0C0C01
1001111111111111111111111111111111111001
10C0C0C0C0C0C0C0C00CC00C0C0C0C0C0C0C0C01
1011111111111111111CC1111111111111111101
1P00000000000000000CC00000000000000000C1
1111111111111111111111111111111111111111