111111111111111111
10000000C000000C01
1001010P00000000C1
10010100000C000001
1001E1000000000C11
111111111111111111