111111111111111111
1C000000000C000001
1000000P00000000C1
10010100000C000001
10010100000C000001
10010100000C000001
1C0101C00000000001
10010100000000C001
100101000000000001
100101000000000001
101C0C1000C0000001
10010100000C0001C1
1C01E1000000000C11
111111111111111111